22222222222222222222
2&&&&&&&&&&&&&&&&&&2
2&&&&&&&&&&&&&&&&&&2
2&&&&&&&&&&&&&&&&&&2
2&&&&&&&&&&&&&&&&&&2
2&&&&&&&&&&&&&&&&&&2
2&&&&&&&&&&&&&&&&&&2
2&4444444&&&&&&&&?&2
2&4888884&&&&&&&&&&2 
2&4888884&&&&&&&&&&2
2&4444444&&&&&&&&&&2
2&&&&&&&&&&?&&&&&&&2
2&&&&&&&&&&&&&&&&&&2
2&&&&&&&&&&&&&&&&&&2
2&&&&&&&&&&&&&&&&&&2
2&&&&&&&&&&&&&&&&&&2
2&&&&&&&&&&?&&&&&&&2
2&&&&&&&&&&&&&&&&&&2
22222222222222222222
22222222222222222222
