0000000?000000000000
00000000000000000000
00000000000000000000
00000000000000000000
00000000000000000000
00000000000000000000
00000000000000000000
00000000000000000000
00000000000000000000
00000000000000000000
00000000000000000000
000000000000"0000000
00000000000000000000
00000000000000000000
00000000000000000000
0000?000000000000000
00000004444440000000
00000004555540000000
000000044444400?0000
00000000000000000000
