Tilemapping Version 1.0 
#tileset 
ressource/tileset1.bmp 
8 1 
tile0: vide //le joueur peut marcher a travers
tile1: plein 
tile2: plein 
tile3: plein 
tile4: plein 
tile5: plein 
tile6: plein 
tile7: plein 
#level 
15 13 
0 0 0 0 0 0 0 0 0 0 0 0 0 0 0 
0 0 0 0 0 0 0 0 0 0 0 0 0 0 0 
0 0 0 0 0 0 0 0 0 0 0 0 0 0 0 
0 0 0 0 0 0 0 0 0 0 0 0 0 0 0 
1 0 0 0 0 0 0 0 0 1 1 1 1 1 0 
0 0 0 0 0 0 0 0 0 0 0 0 0 0 0 
0 0 0 0 0 0 0 0 0 0 0 0 0 0 0 
0 0 0 0 0 0 0 0 0 0 0 0 0 0 0 
0 0 3 4 0 0 0 2 2 2 2 0 0 2 2 
0 0 5 6 0 0 0 0 0 0 0 0 0 0 0 
0 0 5 6 0 0 0 0 0 0 0 0 0 0 0 
0 0 5 6 0 0 0 0 0 0 0 0 0 0 0 
7 7 7 7 7 7 7 7 7 7 7 7 7 7 7 
#fin