44444444444444444444
44444444444444444444
44444444444444444?44
44444444444444444444
44444444444444444444
44444444444444444444
4444444444?444444444
44444444444444444444
44444444444444444444
44444444444444444444
4444444444444444"444
44444111111111444444
44444166666661444444
44444166666661444444
44444111111111444444
4444444444444444?444
44444444444444444444
44444444444444444444
4?444444444444444444
44444444444444444444
