55555555555555555555
55555555555555555555
55555555"55555555555
55557777755555555555
55557999755555555555
55557999755555555555
55557777755555555555
55555555555555555?55
55555555555555555555
55555555555555555555
5555?555555555555555
55555555555555555555
55556666666665555555
55556111111165555555
55556111111165555555
55556666666665555555
55?55555555555555555
55555555555555555555
55555555555555555555


